111111111111111111111111111111111111111111111
1PC00000C00000X0000C00000X00000C000000000C0E1
10101C1010101010101010101C101C1C101C101010101
10C00X000C0000C000C0000C000X000C0C0000C000001
10101010101010101C1C1010101010101010101010101
10C000C00C000C0C000000C0000C0000C000C000C0001
101C101C1010101010101010101010101C101X1010101
10C000000C00X00C00C0000C0000C000000C0C0000001
10101C10101C1C10101010101C101010101C101010101
1C000000C0000X0C000C000000000000C000C00XC0001
10101C1010101C1010101010101010101010101010101
10C000C000C000000C00000000000C000X0000C000001
101010101C101C10101010101010101C1C10101X1C101
100000C000000X0X000X0C0000000C00X0000C0000001
101C1C10101C1C10101C10101C10101010101010101C1
10000000XC000000000000C00000000000000C0X00001
1010101C10101C10101010101C101010101010101C101
10000C000C0X000000C0X00000000000C000X00000001
10101010101C10101010101010101C101010101010101
1000000C0000000000C0000000C0X00000000C0000001
101C1C1010101010101010101C10101C10101C1010101
100X00C000000000C0000C0000000000C00X000C00001
1C10101C101C10101C10101010101010101C1010101C1
100C000XX000C0000C0000C000C0000X0000C00000001
111111111111111111111111111111111111111111111