11111111111111111111111111111111111111111111111111111111111111111111111
1000000C1X1X1C1C1000C00000000000C0000C0000C000000C00000XX000000C0C00001
10XC0X00101C10101CC1110101010C11111111111111111111111111111111111111C01
10000110000000X00001X10000C000000CX100C1X1000CC10X00010CC01C01X01001001
10110C10111111111001110101010000000000000000000000000000000000000000001
1C00C11000000000000000P000000010101X10101C1C101C101X101C10101X101C10001
10110C1101C1C1C1C1C1C1C1C1C1000101C101X10101C101X101C1C101C101X101C1001
10000110X0X000X0X000X000X0X00000000000000000000000000000000000000000001
10110C1101C1C1C1C1C1C1C1C1C10101010010111011101110101010101010101010101
1C0C0110000000000000000000000000000110001000100010000000000000000000001
1C110C1C100110X110011010101010101000101110111001001010101X1010101010011
10CX0110010C1X001X0110000C0000C00000100010001001000X000000X000X000001E1
1X110X100C1000C00C00C010101X101X10101011101110010010101X101010101001C01
1000011C1001C011111110000X0C000X00000C0000C000000000C000X00C0000001C011
1C110C101X001001C1CC1010101X1010101C1C1C101C1010101C1010101X101001X0C01
1000011X010CC10000X0C00C00C00X00X0000C0000000XC000000XC00000C0001111101
10110X110X111010C0X000101X1010101C101X101X101C1X101C1C101X101001X1X1C01
1000011X0100C1C0000C000C000C000C00000000000000C00X000000X000001101C1001
1C110X101X0X1001111100101C1010101C101C10101X101C10101010101001C10C00001
1XX0011010C1C00CC0X10000000C000000000000C00000000000000000001X011111101
1011001C0C1C010111X11111101X1X101C101C10101C10101C1X1010100100000CCC101
10XX011001001C00C1CCCCCCC000C00000C000C00X00000C000C0000C010C1111111101
1C110C1010C01111011111111C101C1X101C101X1C1C101C1X101X10C1001C1C101X101
10C001000C0X0X00X0C000CC00C0000000C000C0X00C0000C00000001X0000000000001
1CCX0C0CX1111111111111111111111111111111111111111111111100C11C1111011X1
1C00X0X0CC0000CCCC000C000C00000000C00C0C0C0C0000000C0C0C01X1XCC11C01101
11111111111111111111111111111111111111111111111111111111111111111111111