11111111111
1000000C001
1P1111111E1
10C0X000C01
11111111111