11111111111111111111111111111
1000000C0000000C0000000000001
10X0XCX0XCX0X0X0X0XCX0XCX0X01
10000C0000C0000000C00000C0001
1PX0XCX0X0X0X0X0XCX0XCX0X0XE1
1000000C0000000C0000000000001
10XCX0XCX0X0XCX0X0XCX0X0X0X01
100C00000C00000000C00000C0001
11111111111111111111111111111