1111111111111111111111111111111111111111111111111111111
1000111110000000001111100000000011111000000000111110001
10010C0X0100000001CX0C01000000010C00C10000000100C0C1001
10100X0C0X10000010CXCC0C1000001CC0C0C010000010C0XP0X101
11C000X00C011111X00C0X0X0111110X00X0CX01111100X00C0C011
100C0ECX0X00C0C00X0X0X0C000CC00CX00XC000C0C0C0C000C0001
11000XX00X01111100CX0C0C0111110C0C0XC001111100C000C0011
1010C0CCX01000001X0C0XC01000001C0C0CX0100000100C0C00101
1001C0C00100000001C0C00100000001CC0C0100000001C0C001001
1000111110000000001111100000000011111000000000111110001
1111111111111111111111111111111111111111111111111111111