111111111111111111111111111111111111111111111111111111111111111
1001111000000000000001100000000000000000000000010000000100100C1
100000010000000000001001000000000000000111111110011111001100111
100111001000000000010000100000000000001000000000100000100001001
10000C100100000000100110010000000000010011111111000000011110001
100111110011111111001001001111111111100100000000000000000C10001
100000001000000000010000100000000000001001111111111111111110001
100111100111111111100110011111111111110010000000001100000000001
100C10C10000000000001001000000000000000100011111001001110111111
1001101111111111111100001111111111111110001E1001001010010000001
100000110000000000000000000000000111110000101010010010011111101
100111101111111111111111111111111000010000001100110100100000001
1P0000010001000100010001000100010001011110010100110100101111111
1001000001000100010001000100010001010000001000100001000000000C1
111111111111111111111111111111111111111111111111111111111111111